1111111
1E00001
1000001
10000C1
1C00001
10000P1
1111111