1111111
1000001
10ECP01
1111111