1111111111111111111
1000001C00000000001
101P001111011111101
10111111C1010111001
1000010000010000001
1C00000101010111001
11010111110001C0011
1001000100011111111
1010100001000001001
1010100100110000001
1010101001011100101
1000100001001110001
111111010101010C011
1000000100010100101
10011111111110001E1
1010001100100000101
1010100001111000101
1010101000111110001
1000100110000000C11
1111111111111111111