1111111
1000001
10E00C1
1111111