1111111
100PP01
10E00C1
1111111