1111111
1E10P01
11000C1
1111111