1111111
1000P01
10000C1
1111111