1111111
1000P01
10E00C0
1111111