1111111
100P01
10E00C1
1111111