1110111
1000P01
10E00C1
1111111