1111111
100P001
10EE0C1
1111111