1111111
1C10P01
11E01C1
1111111