1111111
1000P00
10E00C1
1111111