1111111
0000P01
10E00C1
1111111