1111111
1a0P001
10E00C1
1111111